булка	food
колбаса	food
сухарики	food
курица	food
тапки	clothes
шапка	clothes
куртка	clothes
сапоги	clothes
ведро	home
мыло	home
мочалка	home
швабра	home
акции	finance
облигации	finance
золото	finance
монетки	finance
текила	drink
пиво	drink
кола	drink
минералка	drink
хагиваги	toy
мячик	toy
кукла	toy
лего	toy
